#####
#P  #
# = #
### #
#+= #
#  +#
#####