############  
#++  #     ###
#++  # =  =  #
#++  #=####  #
#++    P ##  #
#++  # #  = ##
###### ##= = #
  # =  = = = #
  #    =     #
  ############