#####
#P  #
# = #
### #
#.= #
#  .#
#####