  #####
###*  #
# P=  #
###  +#
#######