############  
#..  #     ###
#..  # =  =  #
#..  #=####  #
#..    P ##  #
#..  # #  = ##
###### ##= = #
  # =  = = = #
  #    =     #
  ############