 ######
#  *  #
#=P=  #
#+## +#
#######