  ##### 
###   # 
#+P=  # 
### =+# 
#+##= # 
# # + ##
#= *==+#
#   +  #
########