 ########
#       #
#   *   #
#=P=   ##
#+## + ##
#########