  #####
###*  #
# P=  #
#*## +#
#######